111111111111111111111111111
1P000000C00000001000C1000C1
111100000001110010000110001
10C11000011100001C000000001
100000000100000000000001001
10000C0001C00000111000010E1
111111111111111111111111111