1111111111111111111111111
1P0000C00000001000C1000C1
1110000001110010000110001
1C1100011100001C000000001
1000000100000000000001001
1000C001C00000111000010E1
1111111111111111111111111