1111111111111111111111111111
1P000000C00000000100C01000C1
1111000000001110010000110001
10C110000111100001C000000001
10000C00010C00000000000100E1
1111111111111111111111111111
