11111111111111111111111111111
1P000000C00000000000001000001
1111000000001110000000110C001
10C110000111100000C0000000001
10000C00010C000000000000000E1
11111111111111111111111111111