1111111111111
1P1000100C011
100C100C010E1
1111111111111