1111111111111111
1P000000C0000001
1000C000000000E1
1111111111111111