1111111111111111
1P010001000C0011
1000C100C00100E1
1111111111111111