1111111111111111
1P010001000C0011
10000100000100E1
1111111111111111