1111111111111111
1P010001C0000C11
1C00C100000100E1
1111111111111111